Spectator = S
Babylon = BAB
Greece = GR
China = CN
Egypt = EG
England = GB
France = FR
Russia = RU
Rome = ROM
Arabia = AR
America = US
Japan = JP
India = IN
Germany = DE
The Ottomans = OTT
Korea = KR
Iroquois = IRO
Persia = PRS
Polynesia = POL
Siam = SI
Spain = ES
Songhai = SNG
Mongolia = MGL
Aztecs = AZT
Inca = INC
Denmark = DK
The Huns = HUN
The Netherlands = NL
Sweden = SE
Austria = AT
Carthage = CAR
Byzantium = BYZ
Celts = CEL
Ethiopia = ETH
The Maya = MAY
Brussels = BRU
Florence = FLO
Hanoi = HAN
Kabul = KAB
Kuala Lumpur = KUL
Lhasa = LHA
Milan = MIL
Quebec City = QC
Cape Town = CPT
Helsinki = HEL
Manila = MNL
Mogadishu = MOG
Rio de Janeiro = RDJ
Sydney = SYD
Ur = UR
Vancouver = VAN
Venice = VEN
Antwerp = ANT
Genoa = GEN
Kathmandu = KTM
Singapore = SGP
Tyre = TYR
Zanzibar = ZAN
Almaty = ALM
Belgrade = BEL
Dublin = DUB
Edinburgh = EDI
M'Banza-Kongo = MBK
Sidon = SID
Valletta = VAL
Bratislava = BTS
Cahokia = CAH
Jerusalem = JRS
Barbarians = BAR